king-umar-bin-nauman-and-sons  |  حكاية الملك عمر النعمان وولديه شركان وضوء المكان
lover-and-the-loved |  حكاية العاشق والمعشوق
ali-bin-bakkar-and-shams-an-nahar  |  حكاية علي بن البكار مع شمس النهار
bird-stories  |  حكاية تتعلق بالطيور
qamr-az-zamaan-bin-sharmaan  |  حكاية الملك قمر الزمان ابن الملك شهرمان
niamah-bin-rabiya |  حكاية نعم ونعمة
alaudeen-abu-shamaat  |  حكاية علاء الدين أبو الشامات
hikayaat-al-kiraam  |  بعض حكايات تتعلق بالكرام
hisham-bin-abdul-malik  |  حكاية هشام بن عبد الملك مع غلام من الأعراب
haroon-ar-rasheed-with-mohammad-al-jawhari |  حكاية هارون الرشيد مع محمد علي الجوهري
khalid-bin-abdullah  |  حكاية خالد بن عبد الله القسري مع الشاب السارق
ali-shaar-with-zumrud  |  حكاية علي شار مع زمرد الجارية
haroon-ar-rasheed-with-ajami  |  حكاية هارون الرشيد مع علي العجمي وما يتبع ذلك من حديث الجراب الكردي
haroon-ar-rasheed-with-jafar  |  حكاية هارون الرشيد مع جعفر والجارية والإمام أبي يوسف
jubayr-bin-umair-with-budur  |  حكاية بدور بنت الجوهري مع جبير بن عمير الشيباني
six-slave-girls  |  حكاية الجواري المختلفة الألوان وما وقع بينهن من المحاورة
wardan-the-buther  |  حكاية وردان الجزار
shahwah-fi-nisaa  |  حكاية تتضمن داء غلبة الشهوة في النساء ودواءها
ashaabu-taawoos-wal-booq-wal-faras  |  حكاية الحكماء أصحاب الطاووس والبوق والفرس
anas-al-wujud  |  حكاية أنس الوجود مع محبوبته الورد في الأكمام
tawaddud-the-slave-girl  |  حكاية تودد الجارية
hassib-kareem-ud-deen  |  حكاية حاسب كريم الدين
sindibad  |  حكاية السندباد
stories-of-jinn-and-shayateen-during-sulayman-as  |  حكاية في شأن الجن والشياطين المسجونين في القماقم من عهد سليمان عليه الصلاة والسلام
city-of-brass  |  حكاية مدينة النحاس
judar-and-his-brethren  |  حكاية جودر بن التاجر عمر وأخويه
hind-bint-numan  |  حكاية هند بنت النعمان
haroon-ar-rasheed-with-bint-arabiyya  |  حكاية هارون الرشيد مع البنت العربية
haroon-ar-rasheed-with-jameel-bin-muammar  |  حكاية جميل بن معمر لأمير المؤمنين هارون الرشيد
dhimrah-bin-mughira  |  حكاية ضمرة بن المغيرة التي حكاها حسين الخليع لهارون الرشيد
dalilah-and-her-daughter-zainab  |  حكاية أحمد الدنف وحسن شومان مع الدليلة المحتالة وبنتها زينب النصابة
king-badr-basim  |  حكاية زواج الملك بدر باسم بن شهرمان ببنت الملك السمندل
saiful-mulook-wa-badeeyatul-jamaal  |  حكاية سيف الملوك وبديعة الجمال
hasan-saaigh-al-basari  |  حكاية حسن الصائغ البصري
masrur-and-zayn-mawasif  |  حكاية مسرور التاجر مع معشوقته زين المواصف
ali-nuruddeen-and-girdle-girl  |  حكاية علي نور الدين مع مريم الزنارية
ruined-man-of-baghdad-and-his-slave-girl  |  حكاية الشاب البغدادي مع جاريته التي اشتراها
wird-khan-bin-jaliad  |  حكاية ورد خان بن الملك جليعاد
abu-qair-wa-abu-swayr  |  حكاية أبي قير وأبي صير
abdullah-albarri-with-abdullah-albahri  |  حكاية عبد الله البري مع عبد الله البحري
haroon-ar-rasheed-with-merchant-of-oman |  من نوادر هارون الرشيد مع الشاب العماني
ibrahim-bin-khaseeb-with-jameela  |  حكاية إبراهيم بن الخصيب مع جميلة بنت أبي الليث عامل البصرة
abu-alhasan-khurasaani  |  حكاية أبي الحسن الخراساني الصيرفي مع شجرة الدر
qamr-az-zamaan-with-his-lover  |  حكاية قمر الزمان مع معشوقته
abdullah-bin-faadhil  |  حكاية عبد الله بن فاضل عامل البصرة مع أخويه
maaruf-al-iskaafi  |  حكاية معروف أل إسكافي
  